kof97	拳王97	KOF97	KOF 97
kof99p	拳王99	KOF99	KOF 99
kof2000n	拳王2000	K0F2000	KOF 2000
kof2001	拳王2001	K0F2001	KOF 2001
kof2002	拳王2002	K0F2002	KOF 2002
kof2003	拳王2003	K0F2003	KOF 2003
kof94	拳王94	K0F94	KOF 94
kof95	拳王95	K0F95	KOF 95
kof96	拳王96	K0F96	KOF 96
kof95h	拳王95加强	K0F95+	K0F95+
kof96h	拳王96加强	K0F96+	K0F96+
kof97pls	拳王97风云再起	K0F97 Plus	KOF97 플러스
kof2000	拳王2000加强版	K0F2000 Plus	K0F2000 Plus
kof2001h	拳王2001加强	K0F2001 Plus	K0F2001 Plus
kf2k2pla	拳王2002加强	K0F2002 Plus	K0F2002 Plus
kf2k2mp	拳王2002魔幻一	K0F2002 Magic	K0F2002 Magic
kf2k2mp2	拳王2002魔幻二	K0F2002 Magic II	KOF 2002 매직II
kf2k2pls	拳王2002风云再起	K0F2002 Super	K0F2002 Super
kof2002b	拳王2002冰蓝	K0F2002 ICE BLUE	K0F2002 ICE BLUE
cthd2003	卧虎藏龙2003	Cth2003	Cth2003
kf2k3bl	拳王 2003（自制版）	The King of Fighters 2003 	킹 오브 파이터즈 2003 
kf2k3pl	拳王 2004 EX Hero 	The King of Fighters 2004 Plus 	킹 오브 파이터즈 2004 Plus 
kf2k3upl	拳王 2004 EX 风云 Plus 	The King of Fighters 2004 Ultra Plus 	킹 오브 파이터즈 2004 울트라 Plus 
kf2k5uni	拳王10周年魔幻II	K0F10Th Unique II	KOF 10주년유니크II
kf10thep	拳王 十周年纪念	The King of Fighters 10th Anniversary Extra Plus	킹 오브 파이터즈 10주년 기념판 엑스트라 Plus
svcsplus	拳王对街霸加强版	SNK Vs Capcom Plus	SNK VS 캡콤플러스
mslug	合金弹头	Metal Slug	메탈슬러그
mslug2	合金弹头2	Metal Slug 2	메탈슬러그 2
mslug3	合金弹头3	Metal Slug 3	메탈슬러그 3
mslug4	合金弹头4	Metal Slug 4	메탈슬러그 4
mslug5	合金弹头5	Metal Slug 5	메탈슬러그 5
mslug3b6	合金弹头6	Metal Slug 6	메탈슬러그 6
mslugx	合金弹头X	Metal Slug X	메탈슬러그 X
mslug3h	合金弹头3加强版	Metal Slug 3+	메탈슬러그 3 플러스
ms5plus	合金弹头5加强版	Metal Slug 5 Plus	메탈슬러그 5 플러스
sf2	街头霸王 II - 天下斗士 	Street Fighter II: The World Warrior 	스트리트 파이터 II - 월드 워리어 	
sf2ud	街头霸王 II - 天下斗士（U）	Street Fighter II: The World Warrior (U)	스트리트 파이터 II - 월드 워리어 (U) 	
sf2hf	街头霸王 II - 战斗宣言 	Street Fighter II': Hyper Fighting 	스트리트 파이터 II' 터보 - 하이퍼 파이팅 	
sf2hfj	街头霸王 II - 战斗宣言（加速版） 	Street Fighter II' Turbo: Hyper Fighting 	스트리트 파이터 II' 터보 - 하이퍼 파이팅 	
sf2hfu	街头霸王 II - 战斗宣言（U） 	Street Fighter II': Hyper Fighting(U) 	스트리트 파이터 II' 터보 - 하이퍼 파이팅 (U)	
sf2rb2	街头霸王 II - 四大天王 	Street Fighter II': Champion Edition 	스트리트 파이터 II' - 챔피언 에디션 	
sf2red	街头霸王 II - 赤色波动 	Street Fighter II': Champion Edition 	스트리트 파이터 II' - 챔피언 에디션 	
sf2dkot2	街霸2四大天王KO TURBO	SFII-T Hy Fighting KO	SFII-T Hy Fighting KO	
ldrun3j	超级运动员 3j - 魔神的复活	Lode Runner III+ - The Golden Labyrinth	로드 러너 III+ - 황금 미로
captcomm	名将	Captain Commando 	캡틴 코만도	
dino	恐龙快打	Cadillacs and Dinosaurs	캐딜락 공룡신세기	
xmen2pj	X - 战警 (2 Players)	X-Men (2 Players)	엑스맨 (2인용)	
xmen	X - 战警 (4 Players)	X-Men (4 Players)	엑스맨 (4인용)	
wof3js	三剑圣	Warriors Of Fate 3Js	천지를먹다 2 해킹버전	
wofhfh	火凤凰	Huo Fenghuang	천지를먹다 2 해킹버전2	
tdragon2	雷龙 2	Thunder Dragon 2	뇌용 2	
1942	1942 - 空中大战 	1942 I	1942	
1942a	1942 - 空中大战 II	1942 II	1942 II	
1943	1943 - 中途岛海战 	1943 The Battle of Midway 	1943 미드웨이 해전 	
1943u	1943 - 中途岛海战 II	1943 The Battle of Midway II	1943 미드웨이 해전 II	
1945kiii	1945k III	1945k III	1945k III	
ffight	快打旋风 	Final Fight 	파이널 파이트 	
ldrun	超级运动员 	Lode Runner 	로드 러너 	
ldrun2	超级运动员 2 - 帝国的逆袭	Lode Runner II - The Bungeling Strikes Back	로드 러너 II - 번질링 스트라이크 백	
ldrun3	超级运动员 3 - 魔神的复活	Lode Runner III - The Golden Labyrinth	로드 러너 III - 황금 미로	
ldrun4	超级运动员 4 - 帝国的脱出	Lode Runner IV - Teikoku Karano Dasshutsu	로드 러너 IV - 제국으로부터의 탈출	
ldruna	超级运动员 II	Lode Runner II	로드 러너 II	
3in1semi	欢乐三合一	XESS	제스	
3kokushi	三刻志 	Sankokushi 	삼각지 	
3stooges	三个傀儡	The Three Stooges In Brides Is Brides	세명의 바보들	
3wonders	奇迹三合一	Three Wonders	쓰리 원더스	
4dwarrio	四次元战士	4-D Warriors	4-D 워리어즈	
4in1	欢乐四合一	4 Fun in 1	4 펀 인 1	
4in1boot	益智游戏王	Puzzle King	퍼즐왕	
800fath	海底潜航 - 800 海里	800 Fathoms	800 패덤즈	
mariner	海底潜航 - 水手	Mariner	매리너	
88games	'88游戏	'88 Games	'88 게임즈	
konami88	科乐美运动会 '88	Konami '88	코나미 '88	
99lstwar	'99 最后战争	'99 The Last War	'99 라스트 워	
actfancr	战斗机器	Act-Fancer Cybernetick Hyper Weapon	액트팬서 사이버네틱 하이퍼 웨폰	
aeroboto	变形战机 Z Aeroboto	Aeroboto	에어로보토	
aerofgt	四国战机	Aero Fighters	에어로 파이터즈	
aerofgtb	四国战机 II	Aero Fighters II	에어로 파이터즈 II	
afighter	战斗任务	Action Fighter	액션 파이터	
agallet	石破天惊	Air Gallet	에어 갈렛	
agress	阿古雷司 - 导弹大战略	Agress	어그레스	
airattck	空袭 	Air Attack 	공습 	
airbustr	空中堡垒	Air Buster	에어 버스터	
ajax	飓风直升机	Ajax	A 잭스	
typhoon	飓风 Typhoon	Typhoon	타이푼	
alexkidd	天空魔城 	Alex Kidd	알렉스 키드	
alexkidd1	天空魔城 II	Alex Kidd II	알렉스 키드 II	
aliens	异形	Aliens	에일리언스	
aliencha	星宿会战 	Alien Challenge	에일리언 챌린지	
aliensec	星际争霸 	Alien Sector	에일리언 섹터	
aliensyn	异形入侵	Alien Syndrome 	에일리언 신드롬 	
aliensyn5	异形入侵 5	Alien Syndrome 5	에일리언 신드롬 5	
alphamis	阿尔法任务	Alpha Mission	알파 미션	
alphaxz	阿尔法任务 Z 	The Alphax Z 	알펙스 Z 	
arian	组合战机	Arian Mission	아리언 미션	
amatelas	圣战士阿玛迪斯	Sei Senshi Amatelass	성전사 아마테라스	
amazon	亚马逊女战士	Soldier Girl Amazon	아마존 여전사	
arabian	阿拉丁	Arabian	아라비안	
arabiana	阿拉丁 II	Arabian II	아라비안 II	
area88	战区 88 I	Area 88 I	에어리어 88 I	
area88r	战区 88 II	Area 88 II	에어리어 88 II	
arkarea	宇宙飞艇	Ark Area	아크 에어리어	
armedff	武装编队 2	Armed Formation 2	암드 포메이션 2	
astorm3	异形风暴	Alien Storm 	에일리언 스톰 	
ashnojoe	小拳王	Ashita no Joe	내일의 죠	
ashurau	阿修罗风暴	Ashura Blaster	아수라 블래스터	
asterixaad	美丽新世界	Asterix	아스테릭스	
astyanax	战王之王	The Astyanax	아스티아낙스	
asuka	飞鸟 	Asuka 	아스카 	
asukaj	飞鸟 II 	Asuka II	아스카 II	
asurabld	血剑王朝 - 魔刃降临	Asura Blade - Sword of Dynasty	아수라 블레이드 - 왕조의 검	
asurabus	血剑王朝 2 - 永恒的战士	Asura Buster - Eternal Warriors	아수라 버스터 - 영원한 전사들	
atetris	俄罗斯方块	Tetris	테트리스	
atlantis	亚特兰蒂斯大作战 I	Battle of Atlantis I	아틀란티스 전투 I	
atomicp	俄罗斯方块解谜	Atomic Point	아토믹 포인트	
aurail1	光环 	Aurail  	아우레일  	
aurail	光环 II	Aurail II 	아우레일 II	
avspirit	复仇精灵	Avenging Spirit	어벤징 스피릿
backfirt	烽火佳人	Back Fire	백 파이어	
baddudes	龙行忍者	Bad Dudes vs. Dragonninja	드래곤 닌자 	
drgninja	龙行忍者 2	Dragonninja 2	드래곤 닌자 2	
bakubrkr	爆裂战机	Bakuretsu Breaker	폭열 브레이커 (일본판)	
bakutotu	爆突机铳艇	Bakutotsu Kijuutei	폭돌기총정 바라듀크 Ⅱ 	
balcube	弹跳方块	Bal Cube	밸 큐브	
ballbros	气球兄弟	Balloon Brothers	벌룬 브러더스	
batlbubl	碰碰球 II	Battle Bubble II	배틀 버블 II	
bankp	银行惊魂记	Bank Panic	은행강도	
baraduke	爆突	Baraduke	바라듀크	
battlane	战斗之路 	Battle Lane 	배틀 레인 	
battlane2	战斗之路 II	Battle Lane II	배틀 레인 II	
battlex	战斗飞梭	Battle Cross	배틀 크로스	
battlnts	反战英雄	Battlantis	배틀란티스	
battroad	赛车之路	The Battle-Road	배틀로드	
bayroute	海湾战争 	Bay Route 	베이 루트 	
gulfwar2	海湾战争 II	Gulf War II	걸프 워 II	
bbros	魔鬼气泡	Buster Bros	버스터 형제	
bchopper	希利大冒险	Battle Chopper	배틀 초퍼	
bcstry	原始人梦语	B.C. Story 	B.C. 스토리 	
bcstrya	原始人梦语 II	B.C. Story II	B.C. 스토리 II	
berabohm	超绝伦人	Beraboh Man	초절륜인 베라보맨	
berlwall	柏林墙	The Berlin Wall	베를린 장벽	
bermudat	百慕大魔鬼三角	Bermuda Triangle	버뮤다 삼각지	
bermudata	百慕大魔鬼三角 (世界大战)	Bermuda Triangle (World Wars)	버뮤다 삼각지 - 세계대전	
bestbest	霸中霸	Best Of Best	베스트 오브 베스트	
bestleag	大联盟足球 (意甲 A)	Best League ( Italian Serie A)	베스트 리그 (세리에 A)	
bestleaw	大联盟足球 (世界杯)	Best League (World Cup)	베스트 리그 (월드컵)	
bestri	打星星	Bestri 	베스트라이	
bgaregga	空战之路	Battle Garegga	배틀 가레가	
bigbang	大轰动	Big Bang	빅뱅	
bigkarnk	古埃及卡纳克传说	Big Karnak	빅 카낙	
bigstrik	大联盟足球	Big Striker	빅 스트라이커	
biomtoy	生化玩具兵	Biomechanical Toy	Biomechanical Toy	
bionicc	希特勒复活	Bionic Commando	바이오닉 코만도		
bladestl	金牌冰上曲棍球	Blades of Steel	블레이드 오브 스틸 	
blandia	快打布兰达	Blandia	블랜디아	
blastoff	原爆战机 	Blast Off	블래스트 오프	
blazeon	魂之光辉	Blaze On	블레이즈 온	
blazer	坦克先锋	Blazer	블레이저	
blkhole	黑洞	Black Hole	블랙홀	
blkpnthr	黑豹	Black Panther	블랙 팬더	
blktiger	暗黑之虎	Black Tiger	블랙 타이거	
blmbycar	意大利巡回赛车	Blomby Car	블롬비 카	
blockcar	黑色嘉年华	Block Carnival / Thunder & Lightning 2	썬더 & 라이트닝 2 / 블럭 카니발	
blockhl	俄罗斯方块 - 黑洞	Block Hole	블럭홀	
blockout2	立体空间方块 II	Block Out II	블럭 아웃 II	
bloodbro	勇士们 - 血兄弟 I	Blood Bros. I	블러드 브러더스 I	
bloodbroa	勇士们 - 血兄弟 II	Blood Bros. II	블러드 브러더스 II	
bluehawk	鹰击蓝空	Blue Hawk	블루 호크	
bluehawkn	鹰击蓝空 (NTC)	Blue Hawk (NTC)	블루 호크 (NTC)	
blueprnt	蓝色拼图	Blue Print	블루 프린트		
brubber	金龟车	Burnin' Rubber	버닝 러버	
upndown	超级金龟车	Up'n Down 	업 앤 다운 	
bodyslam	女子摔角	Body Slam	바디 슬램 	
boggy84	弹跳王 '84	Boggy '84	보기 '84	
bombjack	炸弹杰克 	Bomb Jack 	봄 잭 	
bjtwin	炸弹杰克 II	Bombjack Twin 	봄 잭 트윈 II	
bjtwina	炸弹杰克 III	Bombjack Twin III	봄 잭 트윈 III	
bombkick	炸弹脚力	Bomb Kick	봄 킥	
bonzeadv	地狱小和尚	Bonze Adventure 	지옥순례 	
bottom9	世界棒球 (T)	Bottom of the Ninth (T)	9회말 야구 (T)	
bouldash	钻石小子	Boulder Dash 2	보울더 대쉬 2	
bounty	游艇危机	The Bounty	바운티	
brain	太空登陆战	Brain	브레인	
shackled	链狱谜城	Shackled	셔클드	
breywood	链狱谜城 2	Breywood 2	브레이우드  2	
brkthru	强行突破 	Break Thru 	강행돌파 	
forcebrk	强行突破 II	Force Break II	포스 브레이크 II	
bssoccer	街头足球	Back Street Soccer	백 스트리트 축구	
btime	汉堡时代 	Burger Time 	버거 타임 	
btimem	汉堡时代 II	Burger Time II	버거 타임 II	
btlfieldb	时空战士	Battle Field	배틀 필드 	
btlkroad	世界武术格斗比赛	Battle K-Road	배틀 K-로드	
bubl2000	泡泡野人版 2000	Bubble 2000	버블 2000	
bub68705	魔幻气泡	Bubble Bobble	버블보블	
bublbobl	魔幻气泡 IV	Bubble Bobble IV	버블보블 IV	
bublboblr	魔幻气泡 (有选择模式)	Bubble Bobble (with mode select)	버블보블 (슈퍼모드 선택버전)	
bucky	宇宙野兔 	Bucky O'Hare 	버키 오 헤어 	
buccanrs	海盗 	Buccaneers 	버커니어스 	
buccanrsa	海盗 II	Buccaneers II	버커니어스 II	
bullfgt	斗牛 	Bullfight 	불파이트 	
thetogyu	斗牛 II 	The Togyu II 	투우 II	
burglarx	夜盗 X	Burglar X	버글러 X	
burnforc	燃烧之魂	Burning Force 	버닝 포스	
bwings	B-计划	B-Wings	B-윙즈 
cabal	勇士们 	Cabal 	카발	
cachat	能源方块	Cachat 	카찻 	
cactus	仙人掌	Cactus 	선인장 	
cadash	卡达叙传说 	Cadash	카다쉬 	
cairblad	空刃	Change Air Blade	체인지 에어 블레이드 	
calibr50	点五零	Caliber 50	캘리버 50	
candance	麒麟 - 加农舞者	Cannon Dancer 	캐논 댄서 	
osman	麒麟 - OS 战警 	Osman	캐논 댄서	
cannball	佳能球气泡 (直立型)	Cannon Ball (horizontal)	캐논볼 (가로화면)	
cannballv	佳能球气泡  (垂直型)	Cannon Ball (vertical)	캐논볼 (세로화면)	
cavenger	宇宙复仇者	Cosmic Avenger	코즈믹 어벤저	
cbuster	暴力克星	Crude Buster 	크루드 버스터 	
cclimbr2	疯狂爬梯者 2 	Crazy Climber 2 	크레이지 클라이머 2 	
cclimbr2a	疯狂爬梯者 2 (难度加强版)	Crazy Climber 2 (Harder)	크레이지 클라이머 2 (고난이도)	
chainrec	魔法方块'95	Chain Reaction'95	매지컬 드롭'95	
magdrop	魔法方块 	Magical Drop	매지컬 드롭 	
magdropp	魔法方块 Plus 	Magical Drop Plus	매지컬 드롭 Plus	
pnickj	魔法方块'94 	Pnickies'94	프닉키즈'94	
chameleo	变色龙	Chameleon	카멜레온	
charlien	糊涂忍者	Charlie Ninja	찰리 닌자	
checkman	检查人	Check Man	체크맨	
cheekyms	打老鼠	Cheeky Mouse	치키 마우스	
chimerab	原生兽 	Chimera Beast 	키메라 비스트 	
chinatwn	唐人街	China Town 	차이나 타운	
chokchok	魔鬼气泡海中对战	Choky! Choky!	초키! 초키!	
chukatai	中华大仙 	Chuka Taisen 	중화대선 	
champwr	冠军摔跤	Champion Wrestler	챔피언 레슬러	
circusc	马戏团 - 小丑查理 I	Circus Charlie I	서커스 찰리 I	
circusc2	马戏团 - 小丑查理 II	Circus Charlie II	서커스 찰리 II	
citybomb	炸弹赛车 	City Bomber 	시티 봄버 	
citycon	碰碰车 I	City Connection I	시티 커넥션 I	
citycona	碰碰车 II	City Connection II	시티 커넥션 II	
motos	莫托斯	Motos	모토스	
cobracom	眼睛蛇指令	Cobra-Command 	코브라 커맨드 	
hexa	魔法宝石 II	Hexa II	Hexa II	
combh	战斗神鹰	Combat Hawk	컴뱃 호크	
commando	战场之狼 I	Commando II	코만도 I	
commandou	战场之狼 II	Commando II	코만도 II	
commsega	桂河大桥 	Commando 	코만도 	
condor	秃鹰 	Condor 	콘도르 	
congo	刚果阿古	Congo Bongo	콩고 봉고	
contra	魂斗罗 	Contra 	혼두라 (魂斗羅) 	
scontra	超级魂斗罗	Super Contra	슈퍼 혼두라 (魂斗羅)	
cookbib	曲吉鼠解谜	Cookie & Bibi	쿠키 & 비비	
cookbib2	曲吉鼠解谜 2	Cookie & Bibi 2	쿠키 & 비비 2	
cookbib3	曲吉鼠解谜 3	Cookie & Bibi 3	쿠키 & 비비 3	
gallop	雷驰 - 武装警察 	Gallop - Armed Police Unit  	갤럽 - 암드 폴리스 유니트  	
cosmogng	外星人趣味射击 	Cosmo Gang the Video 	코스모 갱 더 비디오 	
cotton	棉花小魔女	Cotton	코튼	
crimec	罪恶都市	Crime City 	크라임 시티	
vendetta2pd	罪恶战士 2 (2 Players )	Vendetta (2 Players)	Vendetta (2 Players)	
vendetta	罪恶战士 2 (4 Players)	Vendetta (4 Players)	벤데타 (4인용)	
crush	顽皮鬼 	Crush Roller 	크러쉬 롤러 	
crusherm	破碎机	Crusher Makochan	크러셔 마코짱	
hcastle	恶魔城堡	Haunted Castle	악마성 드라큘라	
cuebrick	砖块拼图大考验 	Cue Brick 	큐 브릭 	
dadandrn	究极战队 I	Kyukyoku Sentai Dadandarn I	구극 전대 다단단 I	
mmaulers	究极战队 II	Monster Maulers II	구극 전대 다단단 II	
daisenpu	大旋风	Daisenpu 	대선풍 	
dangseed	魔种 	Dangerous Seed	데인져러스 시드	
darkmist	失落的城堡	The Lost Castle In Darkmist	다크 미스트	
darkseal	暗黑封印 - 毁灭之门 	Dark Seal 	다크 씰 	
darktowr	黑暗之塔	Dark Tower	다크 타워	
darwin	黑暗之风 	Darwin 4078 	다윈 4078	
dblewing	双翼	Double Wings	쌍날개 - 더블 윙즈 (한국판)	
dblpoint	夜上海 I	Double Point I	더블 포인트 I	
dblpointd	夜上海 II	Double Point II	더블 포인트 II	
dbreed	龙族少年	Dragon Breed 	드래곤 브리드	
dcon	地球防卫军	D-Con	D-콘	
ddonpach	怒首领蜂 I	DoDonPachi II 	도돈파치 I	
ddonpachj	怒首领蜂 II	DoDonPachi II 	도돈파치 II	
ddragon	双截龙	Double Dragon	더블드래곤	
ddragon2	双截龙II	Double Dragon II	더블드래곤 2	
ddragon3	双截龙III	Double Dragon III	더블드래곤 3	
ddux1	怪鸭冒险记 I	Dynamite Dux I	다이너마이트 덕스 I	
ddux	怪鸭冒险记 II	Dynamite Dux II	다이너마이트 덕스 II	
deadconx	死亡边缘 	Dead Connection 	데드 커넥션 	
demonwld	步步惊魂 I	Demon's World I 	데몬스 월드 I	
devilw	魔兽王国	Devil World 	데빌 월드	
devstors	饿流祸 	Devastators 	약탈자 	
dfeveron	弹铳 I	Dangun Feveron 	탄총 피버론 	
feversos	弹铳 II	Fever SOS 	피버 SOS	
dharmak	达摩道场 II	Dharma Doujou II	망치맨 달마도장 II	
dietgo	乐乐小子 	Diet Go Go 	다이어트 Go Go 	
digdug2	挖金子 	Dig Dug 	디그 더그 	
shippumd	疾风魔法大作战 I	Shippu Mahou Daisakusen (Japan)	질풍 마법대작전 (일본판)	
kingdmgp	疾风魔法大作战 II	Kingdom Grandprix	킹덤 그랑프리 (세계판)	
diverboy	潜水宝宝	Diver Boy	다이버 보이	
dland	梦想大陆	Dream Land	드림랜드	
docastle	嘟先生的城堡 I 	Mr. Do's Castle I 	미스터 도의 성 I	
dogfight	空中缠斗 	Dog Fight 	도그 파이트 	
dogosoke	怒号层圈 II	Dogou Souken II 	노호층권 II	
dondokod	木匠兄弟 I	Don Doko Don I	돈 도코 돈 I	
dondokodu	木匠兄弟 II	Don Doko Don II	돈 도코 돈 II	
donpachi	首领蜂 I	DonPachi I	수령봉 I	
donpachikr	首领蜂 II	DonPachi II	수령봉 (首領蜂)II 	
dowild	嘟先生的暴走	Mr. Do's Wild Ride	미스터 도 와일드 라이드	
dreamwld	梦想世界	Dream World	드림월드	
drgnbowl	七龙珠	Dragon Bowl	드래곤 보울	
drgnbstr	屠龙记	Dragon Buster	드래곤 버스터	
drgnunit	魔城龙魂	Dragon Unit / Castle of Dragon	드래곤 유닛 / 캐슬 오브 드래곤	
drgw2	中国龙 II	Dragon World II	중국룡 II	
drmicro	米克罗博士	Dr. Micro	마이크로 박사	
drtoppel	托比博士探险队 	Dr. Toppel's Adventure 	토플박사의 모험 	
dspirit	龙魂 	Dragon Spirit 	드래곤 스피릿 	
dyger	特攻队I	Dyger I	다이거 I	
dygera	特攻队 II	Dyger II	다이거 II	
dynablst	炸弹人 I 	Bomber Man I	봄버맨 I	
bombrman	炸弹人 II	Bomber Man II	봄버맨 II	
dynagear	恐龙时代	Dyna Gear	다이나 기어	
dynwar	吞食天地	Dynasty Wars	삼국지	
earthjkr	地球战役	Earth Joker	어스 조커	
edf	地球防卫军	Earth Defense Force	지구방위군	
eightfrc	8 号火力	Eight Forces	에이트 포스	
esckids	脱线行大运 (4 Players)	Escape Kids (4 Players)	이스케이프 키즈 (4인용)	
esckidsj	脱线行大运 (2 Players)	Escape Kids (2 Players)	이스케이프 키즈 (2인용)	
esprade	长空超少年	ESP Ra.De.	에스프레이드 	
eto	古今东西干支物语 	Kokontouzai Eto Monogatari 	동서고금 십이지 이야기 	
evilston	魔门地狱石	Evil Stone	에빌 스톤	
excelsr	破坏王	Excelsior	엑셀시오르	
exedexes	超浮游要塞	Exed Exes	엑시드 엑시즈	
skyfox	天狐 II	Sky Fox	스카이 폭스	
explbrkr	爆裂战机 	Explosive Breaker	익스플로시브 브레이커	
extdwnhl	极限滑降 	Extreme Downhill 	익스트림 다운힐 	
exzisus	行星任务 	Exzisus 	익스지서스 	
fantland	魔幻大地 I	Fantasy Land I	판타지 랜드 I	
fantlanda	魔幻大地 II	Fantasy Land II	판타지 랜드 II	
fantzonep	神奇地带特别版	Fantasy Zone p	판타지 존 p	
farmer	农夫叛乱物语 	Farmers Rebellion	파머즈 레벨리온	
ikki	农夫叛乱物语 II 	Ikki  	농부의 반란 	
fastfred	飞天快手佛莱迪	Fast Freddie	패스트 프레디	
fhawk	战斗猎鹰 	Fighting Hawk 	파이팅 호크 	
finalizr	超级变形战机	Super Transformation	슈퍼 트랜스포메이션	
finalttr	俄罗斯方块终结者	Final Tetris	파이널 테트리스	
finehour	决战时刻	Finest Hour 	파이니스트 아워 	
firehawk	火鹰 	Fire Hawk	파이어 호크	
fixeight	地狱英雄传说	FixEight 	지옥의 영웅전설	
flashgal	霹雳娇娃	Flashgal 	플래시걸 	
flickys1	小鸟妃奇 I	Flicky I	플릭키 I	
flicky	小鸟妃奇 II	Flicky II	플릭키 II	
flipull	小鸡益智方块	Flipull	플리풀 	
plotting	小鸡益智方块 I 	Plotting I	플로팅 I	
plottingu	小鸡益智方块 II 	Plotting II	플로팅 II	
flyboy	飞天男孩	Fly-Boy	플라이 보이	
flytiger	飞虎队	Flying Tiger	플라잉 타이거	
fncywld	异想世界	Fancy World	팬시 월드	
fnkyfish	疯狂的鱼	Funky Fish	펑키 피쉬	
footchmp	冠军杯足球赛	Football Champ 	풋볼 챔프	
formatz	变形战机 Z	Formation Z	포메이션 Z	
freeze	太空人迷宫	Freeze	프리즈	
frogger	青蛙过河	Frogger	프로거	
fround	拳击决赛 I	The Final Round 	파이널 라운드 	
hpuncher	拳击决赛 II	Hard Puncher 	피투성이가 된 영광	
fshark	飞翔鲛 I	Flying Shark I	플라잉 샤크 I	
fsharkbt	飞翔鲛 II	Flying Shark II	플라잉 샤크 II	
hishouza	飞翔鲛 III	Hishou Zame III	비상 상어 III	
skyshark	飞鲨	Sky Shark 	스카이 샤크	
fstarfrc	最终星际武力	Final Star Force 	파이널 스타포스 	
funkybee	疯狂蜜蜂	Funky Bee	펑키 비	
funybubl	性感谜球回路	Funny Bubble	퍼니 버블	
funybublc	性感谜球回路 II 	Funny Bubble II	퍼니 버블 II	
fx	星际任务	F-X	F-X	
galaxygn	星系炮火	Galaxy Gunners	갤럭시 거너즈	
galhustl	开仑骗子	Gals Hustler	갈스 허슬러	
galmedes	高米达斯星战 	Galmedes 	갈메데스	
ganryu	武藏严流记	Ganryu	무장암류기	
gardia	巡弋飞艇	Gardia 	가르디아 	
garogun	韩语问答	Garogun Seroyang	가로군 세로양 	
garyoret	卧龙列传	Garyo Retsuden	와룡열전 	
gaunt2	圣铠 II	Gauntlet II	건틀렛 II	
gaunt22p1	圣铠 II (2 Players)	Gauntlet II (2 Players)	건틀렛 II (2인용)	
gberet	绿色兵团	Green Beret	그린베레	
gbusters	疯狂警察 I	Gang Busters I	갱 버스터즈 I	
gbustersa	疯狂警察 II	Gang Busters II	갱 버스터즈 II	
gemini	捉虫敢死队	Gemini Wing	Gemini Wing	
genix	魔鬼气泡牛仔版	Genix Family	제닉스 패밀리	
ghostb3	迷宫猎人 G (3 Players)	The Real Ghostbusters (3 Players)	리얼 고스트버스터 (3인용)	
gigasm2b	打砖块战斗台 2	Gigas Mark II	기가스 마크 II	
gijoe	特种部队	G.I. Joe	G.I. 조	
ginganin	银河任侠传 	Ginga NinkyouDen 	은하임협전 	
gmgalax	小精灵	Ghostmuncher	고스트멍커 갤럭시안 	
goldnaxej	战斧 II	Golden Axe II	골든 엑스 II	
gotcha	科乐美迷你游戏97 	Got-cha Mini Game Festival 97	빠샤빠샤 미니게임 페스티벌 97	
bishi	科乐美迷你游戏 	Bishi Bashi Championship Mini Game Senshuken	비시바시 챔피언쉽 미니게임 선수권	
ppchamp	迷你游戏  	Pasha Pasha Champ Mini Game Festival	빠샤빠샤 미니게임 페스티벌	
grdians	电神魔傀 II	Denjin Makai II	전신마괴 II	
grdnstrm	圣战 - 守护风暴	Guardian Storm	전신 - 가디언 스톰	
grobda	坦克大战 	Grobda 	그로브다 	
grobda3	坦克大战 II	Grobda II	그로브다  II	
gtmrusa	1000 英里大师赛车	Great 1000 Miles Rally	그레이트 1000마일 랠리	
gtmr2	1000 英里大师赛车 2	Mille Miglia 2: Great 1000 Miles Rally	그레이트 1000마일 랠리 2	
gulfstrm	海湾风暴	Gulf Storm	걸프 스톰	
gunbird	武装飞鸟 I	Gunbird I	건버드 I	
gunbirdk	武装飞鸟 II	Gunbird II	건버드 II	
gundhara	铳弹岚	Gundhara	총탄남	
gundl94	枪牌 94	Gun Dealer '94	건 딜러 '94	
gunfront	枪之国度 I	Gun & Frontier I	건 & 프론티어 I	
gunfrontj	枪之国度 II	Gun Frontier II	건 프론티어 II	
gunmast	枪王	Gun Master	건 마스터	
gunsmoke	荒野大镖客 	Gun.Smoke 	건 스모크
gyrodine	战斗直升机	Gyrodine	자이로다인	
hachoo	破兆	Hachoo!	파조!	
hal21	骇物 21	HAL21	HAL21	
hardhead	铁头小子	Hard Head	짱구박사	
hardhea2	铁头小子 2	Hard Head 2	짱구박사 2	
hasamu	霸沙梦	Hasamu 	패사몽 	
hellfire	地狱火 (2P 版)	Hellfire (2P set)	헬파이어 (2인용)	
heuksun	五子棋 	Heuk Sun Baek Sa 	흑선백사 	
hexion	蜂巢俄罗斯方块 	Hexion 	헥시온 	
hexpoola	魔法台球 	Hex Pool 	헥스 풀 	
racknrol	魔法台球 II	Rack + Roll	랙 + 롤	
hharry	大工之源先生	Hammerin' Harry 	망치소년	
higemaru	海盗船水手	Pirate Ship Higemaru	히게마루 해적선	
honeydol	蜜蜂玩偶	Honey Dolls	허니 돌	
hopmappy	跳跳鼠	Hopping Mappy	호핑 매피	
hopprobo	弹簧机器人	Hopper Robo	호퍼 로보	
horizon	飞越地平线	Horizon	호라이즌	
hotbubl	泡泡野人版 	Hot Bubble	핫 버블	
hotdogst	眩之风暴	Hotdog Storm 	핫도그 스톰 	
htchctch	魔法绿兵卫	Hatch Catch	해치 캐치 (한국판)	
hyperpac	疯狂小精灵	Hyper Pacman	하이퍼 팩맨	
hypsptsp	疯狂运动会	Hyper Sports	하이퍼 스포츠 스페셜 	
imgfight	梦幻战机	Image Fight 	이미지 파이트 	
insectx	杀虫战记	Insector X	인섹터 X 	
ironhors	大列车强盗	Iron Horse	대열차 강도	
jackal	赤色要塞	Jackal	특수부대 자칼	
jjack	跳跃杰克	Jumping Jack	점핑 잭	
jjsquawk	鹦鹉历险记	J. J. Squawkers	J. J. 스쿼커즈	
joinem	精灵鬼	Joinem	조인엠	
jumppop	吸尘器小子 II	Jumping Pop II	점핑 팝 II	
tumblep	吸尘器小子 特别版	Tumble Pop 	텀블 팝 	
jrpacman	小精灵 Jr.	Jr. Pac-Man	쥬니어 팩맨	
jumpbug	跳跳车	Jump Bug	점프 버그	
jumpcoas	跳跃游乐园	Jump Coaster	점프 코스터	
jumpkids	跳跃顽童	Jump Kids	점프 키즈	
junofrst	第一战机	Juno First	주노 퍼스트	
kageki	火激 	Kageki 	화격	
kamenrid	假面骑士俱乐部	Masked Riders Club Battle Race	가면라이더 클럽 배틀 레이스	
kangaroo	袋鼠	Kangaroo	캥거루	
karatblzu	斗神光辉 	Karate Blazers 	가라데 블레이저스 	
karianx	卡琳魔宝 	Karian Cross 	카리안 크로스 	
kbash2	猫王 2 	Knuckle Bash 2 	너클 배쉬 2 	
kickboy	踢球少年	Kick Boy	킥 보이	
kickoff	足球开幕赛 	Kick Off 	킥 오프 	
kickridr	暴力机车赛	Kick Rider	킥 라이더	
kidniki	快杰洋枪	Kid Niki - Radical Ninja 	쾌걸 얀차마루	
kikcubic	迷宫岛 	Meikyu Jima 	미궁도	
kikcubicb	迷宫岛 II	Kickle Cubele	킥클 큐벨레	
kingball	国王与气球 	King & Balloon 	킹 & 벌룬 	
kncljoe	惩奸锄恶 	Knuckle Joe 	너클 죠 	
knights	圆桌骑士	Knights of the Round 	원탁의 기사 	
ksayakyu	草野球	Kusayakyuu	동네야구	
ktiger	究极虎	Kyukyoku Tiger 	구극 타이거 	
kuhga	空牙 - 行动代号	Kuhga - Operation Code 'Vapor Trail'	공아(空牙) - 오퍼레이션 코드 '베이퍼 트레일'	
vaportra	空牙 - 行动代号 II	Vapor Trail - Hyper Offence Formation	공아(空牙) - 베이퍼 트레일	
kungfum	成龙踢馆	Kung-Fu Master	쿵후 마스터	
kyros	柯罗斯传说	Kyros	카이로스	
kyrosj	柯罗斯传说 II	Kyros No Yakata II	카이로스의 저택 II	
kyustrkr	最后足球	Last Striker	라스트 스트라이커	
labyrunrk	拉比林特斯森林 	Labyrinth Runner 	라비린스 러너 	
tricktrp	拉比林特斯森林 II	Trick Trap II	트릭 트랩 II	
ladybug	小瓢虫	Lady Bug	무당벌레	
ladymstr	新功夫少女	Lady Master of Kung Fu	레이디 마스터 오브 쿵후	
lastday	末日危机 	The Last Day 	라스트 데이	
lastdaya	末日危机 II	The Last Day II	라스트 데이 II	
lastduel	行星战争 2012 	Last Duel 	라스트 듀얼 	
lastfort	牌砦	Last Fortress - Toride	패채 (牌砦)	
lastmisn	最终任务 	Last Mission 	라스트 미션 	
lastmisnj	最终任务 II	Last Mission II	라스트 미션 II	
ledstorm	道路风暴 	Led Storm 	레드 스톰 	
legend	传奇	Legend	레전드	
legion	超时迷宫 	Legion - Spinner-87 	초시미궁 레지온 	
lifefrce	沙罗曼蛇 	Lifeforce (US)	라이프포스 (미국판)	
salamand	沙罗曼蛇 II	Salamander II	사라만사 II	
liquidk	丑八怪大冒险 	Liquid Kids 	리퀴드 키즈 	
lizwiz	蜥蜴巫师大作战	Lizard Wizard	리자드 위자드	
cottong	轨道拼图 Cotocoto Cottong	Cotocoto Cottong	코토코토 코통	
gutangtn	轨道拼图 II 	Guttang Gottong	구땅 가땅	
locomotn	轨道拼图 III 	Loco-Motion	로코 모션	
lomakai	魔魁传说	Legend of Makai	레전드 오브 마카이	
makaiden	魔魁传说 II	Makai Densetsu	마계전설	
lordofk	战斗之王	The Lord of King 	로드 오브 킹 	
losttomb	盗募者 (容易版)	Lost Tomb (easy)	잃어버린 무덤 (저난이도)	
losttombh	盗募者 (困难版)	Lost Tomb (hard)	잃어버린 무덤 (고난이도)	
lotlot	空间转移	Lot Lot	로트 로트	
lwings	翼人 	Legendary Wings 	레전더리 윙스 	
lwings2	翼人 II	Legendary Wings II	레전더리 윙스 II	
m660	太空任务 660 	Mission 660 	미션 660 	
macross2	超时空要塞 II	Super Spacefortress Macross II 	초시공요새 마크로스 II	
madgear	疯狂机车	Mad Gear 	매드 기어 	
madshark	狂鲨任务	Mad Shark	매드 샤크	
magicbub	魔法泡泡	Magic Bubble	매직 버블	
mahoudai	魔法大作战 	Mahou Daisakusen	마법대작전	
mangchi	曼翅	Mang-Chi	망치 (한국판)	
maniacsq	疯狂方块 	Maniac Square 	매니악 스퀘어 	
manybloc	拉霸拼图	Many Block	매니 블럭	
mappy	猫捉老鼠 	Mappy 	매피 	
markham	飞碟入侵	Markham	마캄	
matchit2	四川省 II	Match It II	사천성 II / 매치 잇 II	
mazinger	铁甲万能侠	Mazinger	마징가 	
mbombrd	摔跤霸王 - 最终之战 	Ultimate Team Battle	머슬봄버 듀오 - 얼티메이트 팀 배틀	
mcatadv	魔猫森林	Magical Cat Adventure	매지컬 캣 어드벤처	
mchampdx	Multi 冠军 豪华版	Multi Champ Deluxe 	멀티 챔프 디럭스	
megablst	空间战机 	Mega Blast 	메가 블라스트 	
meikyuh	迷宫猎人 G 	Meikyuu Hunter G 	미궁 헌터 G 	
meikyuha	迷宫猎人 G II	Meikyuu Hunter G II	미궁 헌터 G II	
mercs	战场之狼 II 	Mercs 	전장의 이리 II	
metafox	沙漠之狐	Meta Fox	메타 폭스	
metalb	黑色合金 	Metal Black 	메탈 블랙 	
metamrph	兽化变形战士	Metamorphic Force	메타몰픽 포스	
metlsavr	合金救助者	Metal Saver	메탈 세이버	
metmqstr	隐忍 	Metamoqester 	은인 - 닌자 마스터	
metrocrs	追赶跑跳碰 I	Metro-Cross I 	메트로 크로스 I 	
metrocrsa	追赶跑跳碰 II	Metro-Cross (set 2)	메트로 크로스 (세트 2)	
mgcrystl	魔法水晶 	Magical Crystals 	매지컬 크리스탈 	
mia	绿色兵团 2 	M.I.A. - Missing in Action 	그린베레 2 / 미싱 인 액션 	
midresu	午夜攻击 	Midnight Resistance 	미드나이트 레지스탕스 	
mirax	鲸鱼星座	Mirax	미락스	
miraxa	鲸鱼星座 II	Mirax (set 2)	미락스 (세트 2)	 	
mmaze	爱丽丝冒险世界 	Marchen Maze 	메르헨 메이즈 	
mofflott	赛车迷宫 	Maze of Flott 	메이즈 오브 플로트 	
momoko	桃子 120%	Momoko 120%	모모코 120% / 시집가는 날	
moonal2	小蜜蜂 2 - 月球异形 2	Moon Alien Part 2	문 에일리언 파트 2	
moonqsr	月球类星体 - 三台合体	Moon Quasar	문 퀘이사	
moremore	益智迷你游戏	More More	퍼즐특급 모아 모아	
moremorp	益智迷你游戏 加强版	More More Plus	퍼즐특급 모아 모아 Plus	
motorace	横越美国 摩托大赛	MotoRace USA	모터레이스 USA	
mouser	老鼠不得了	Mouser	마우저	
mrflea	弗列克惊异大冒险	The Amazing Adventures of Mr. F. Lea	미스터 F. Lea의 어메이징 어드벤쳐	
mrgoemon	五右卫门先生 	Mr. Goemon 	미스터 고에몽 	
kov	三国战记	Knights Of Valour	삼국전기
kovpls	三国战记2007	Kov 2007	삼국전기 2007
kovplus	三国战记加强版	KOV Plus	삼국전기플러스
kovqyz	三国战记群英传	KOV QunYingZhuan	삼국전기히어로
kovsh	三国风云再起	KOV Super Heroes	삼국전기슈퍼히어로
kovshf	三国武将争霸反	KOV Super Heros F	삼국전기슈퍼히어로 F
kovshz	三国武将争霸正	KOV Super Heros Z	삼국전기슈퍼히어로 Z
kovplusf	三国战记集气快	KOV Plus Power Fast	삼국전기플러스파워패스트
kovplusf2	三国战记2007集气快	KOV 2007 Power Fast	삼국전기 2007 파워패스트
kovshp	三国战纪乱世枭雄	KOV Splus	삼국전기 S플러스
kovytzy	三国战纪一统中原	KOV Ytzy2	삼국전기일통중원2
kovshy	三国一统中原	KOV Ytzy1	삼국전기일통중원1
kov2	三国战记2	Knights Of Valour 2	삼국전쟁기 2
kov2p204	三国战记2加强	Knights Of Valour 2+	삼국전쟁기 2 강화하다
kov2p205	三国战记2雄霸三国	KOV 2 Dragons	삼국전기 2 드래곤
orlegend	西游记	Oriental Legend	서유기
olds103t	西游记2	Oriental Legend Super	서유기슈퍼
oldsplus	西游2之群魔乱舞	Oriental Legend SP	서유기스폐셜
killbldp	傲剑狂刀	The Killing Blade +	傲剑마니아칼
martmast	形意拳	Martial Masters	마샬마스터즈
theglad	 神剑伏魔录	theglad	theglad
sfiii3nr1	街霸3最终冲击	Street Fighter III 3Rd S	스트리트파이터 III 3rd 스트라이크
sfiii2n	街霸3第二冲击	Street Fighter III 2ND	스트리트파이터 II 2nd
sfiiij	街霸3新的时代	Street Fighter III	스트리프파이터 III
sfiii3	街霸3最终冲击	Street Fighter III	스트리트파이터 III
jojonr2	奇妙冒险	Jojo's Venture	조조의기묘한모험 V
jojoban	奇妙冒险2	Jojo's Bizarre Adv	조조의기묘한모험 B
s1945p	彩京1945 Plus	Strikes 1945 Plus	스트라이커즈 1945 플러스
s1945ii	彩京1945II	Strikers 1945 II	스트라이커스 1945 II
s1945iii	彩京1945III	Strikers 1945 III	스트라이커스 1945 III
sf2tlona	街霸2四大天王屠龙	SFII-Tu Long	SF2-Tu Long
wof3js	三剑圣	Warriors Of Fate 3Js	천지를먹다 2 해킹버전
knightsh	铁甲英豪	Knights Of The Round2	원탁의기사해킹버전
shinfz	忍FZ-2006	Shinobi . FZ-2006	시노비 FZ-2006
jojon	奇妙冒险	Jojo's Venture	조조의기묘한모험 V
jojobaner1	奇妙冒险2	Jojo's Bizarre Adv	조조의기묘한모험 B
arcadian	雷暴英雄	Arcadia	아카디아
chinagat	中华门	China Gate	장쑤성
astorm	异形风暴	Alien Storm	에어리언스톰
bonkadv	原始人	Bonk's Adventure	PC 고인돌
desertbr	大漠之王	Desert Breaker	데저트브레이커
redeartn	赤色大地	Red Earth	레드어스
svg	圣魔世纪	SPECTRAL VS GENERATION	SPECTRAL VS GENERATION	
dmnfrnt	魔域战线	Demon Front	Demon Front
baddudes	龙行忍者	Dragonninja	드래곤닌자
eswatbl	霹雳双警	E-Swat Cyber Police	E스왓사이버폴리스
ctribe	流氓大混战	The Combatribes	컴뱃트라이브스
ddragon3	双截龙III	Double Dragon III	더블드래곤 3
aodk	热血进行曲	Aggressors of Dark Kombat	A.D.K공급사
sdodgeb	超级躲避球	Super Dodge Ball	테크노스 재팬
batsuguna	疯狂枪支	Batsugun	바츠군
batsugunsp	疯狂枪支特别版	Batsugun-Special	바츠군SP
sfa	少年街霸 	Street Fighter Alpha 	스트리트 파이터 알파
sfa2	少年街霸 2 	Street Fighter Alpha 2 	스트리트 파이터 알파 2 	
sfa3	少年街霸 3 	Street Fighter Alpha 3 	스트리트 파이터 알파 3
mrheli	希利大冒险	Mr. HELI no Dai-Bouken	미스터 헬리의 대모험	
mrkougar	鬼灵精先生	Mr. Kougar	미스터 쿠가	
mrviking	失落的维京人 	Mister Viking 	미스터 바이킹 
msbingo	宾果小姐拼图方块	Miss Bingo	미스 빙고	
mschamps	吃豆人 超级女孩版	Ms. Pacman Champion Edition	미즈 팩맨 챔피언 에디션	
msgogo	老鼠射击 GoGo	Mouse Shooter GoGo	마우스 슈터 고고	
msgundam	机动战士高达	Mobile Suit Gundam	기동전사 건담	
mspacman	吃豆人	Ms. Pac-Man	미즈 팩맨	
mspacmnf	吃豆人 II	Ms. Pac-Man II	미즈 팩맨 II 	
mspacpls	吃豆人 Plus	Ms. Pac-Man Plus	미즈 팩맨 Plus	
mspuzzleg	美少女解谜拼图 	Miss Puzzle 	미스 퍼즐 	
mstadium	世界棒球 	Main Stadium 	메인 스타디움 	
mstworld	妖怪世界 	Monsters World 	몬스터 월드 	
msword	魔法剑 - 英雄的幻想 	Magic Sword: Heroic Fantasy 	매직 소드 - 영웅 판타지 	
mtwins	双麒儿 	Mega Twins 	치키치키 보이즈 / 메가 트윈스 	
mugsmash	火线追缉	Mug Smashers	머그 스매셔즈	
multchmpk	Multi 冠军 	Multi Champ 	멀티 챔프 	
mvpj	棒球 MVP  I 	MVP (set 1)	MVP (세트 1)	
mvp	棒球 MVP  II	MVP (set 2)	MVP (세트 2)	
mwarr	世纪战士	Mighty Warriors	마이티 워리어즈	
myhero	我的英雄 	My Hero 	청춘 1번지 / 마이 히어로 	
myqbert	立体跳方块 - 米勒耶勒	Mello Yello Q*bert	멜로 옐로 큐*버트	
mystwarr	怒之忍者 	Mystic Warriors 	미스틱 워리어즈 	
naname	娜娜米魔法方块 	Naname de Magic! 	대각선으로 매직! 	
navarone	战舰	Navarone	나바론	
nemo	梦幻冒险 	Nemo 	니모 	
neobattl	SD高达 - 新的战斗 	SD Gundam Neo Battling 	기동전사 SD 건담 네오 배틀링 	
news	魔法美女气泡 	News 	뉴스 	
newsa	魔法美女气泡 II 	News (set 2)	뉴스 (세트 2)	
newsin7	新辛巴达 7	New Sinbad 7	뉴 신밧드 7	
ninjak	忍者小子 	The Ninja Kids 	닌자 키즈 	
ninjakd2	忍者君 II 	Ninja-Kid II 	닌자군 아수라의 장 	
ninjakun	忍者君 - 魔城冒险	Ninjakun Majou no Bouken	닌자군 마성의 모험	
nmg5	益智五合一	Multi 5 / New Multi Game 5	멀티 5	
nob	怪叔叔救美 	Noboranka 	오르는거야 / 노보랑카 	
nrallyx	新迷魂车 X	New Rally X	뉴 랠리 X / 뉴 방구차	
nspirit	最后忍道	Ninja Spirit	최후의 인도 / 닌자 스피릿	
nunchaku	功夫少女	Nunchackun	눈챠크군	
ohmygod	天神方块 	Oh My God! 	오 마이 갓! 	
oisipuzl	益智博士	Oishii Puzzle Ha Irimasenka	맛있는 퍼즐은 필요하지 않습니까	
omegaf	欧米加战机	Omega Fighter	오메가 파이터	
omegafs	欧米加战机 特别版	Omega Fighter Special	오메가 파이터 스페셜	
onetwo	消除牌 - 1+2	One + Two	원 + 투	
orbs	转动球盘 	Orbs 	오브 	
oscar	钢铁金刚 	Psycho-Nics Oscar 	사이코닉스 오스카 	
outzonea	异域战将 II 	Out Zone (set 2)	아웃 존 (세트 2)	
ozon1	自走炮 1	Ozon I	오존 I	
p47	P-47 - 野马中队 	P-47 - The Phantom Fighter 	P 47 - 팬텀 파이터 	
pacgal	吃豆人 Pac-Gal	Pac-Gal	팩-걸	
pacland	小精灵世界 	Pac-Land 	팩 랜드 	
pacmania	疯狂小精灵	Pac-Mania	팩매니아	
pacplus	吃豆人 Plus	Pac-Man Plus	팩맨 Plus	
pang	魔鬼气泡 	Pang (set 1)	팡 (세트 1)	
pangpang	乓乓	Pang Pang	팡 팡	
pangpoms	气球小子	Pang Pom's	팡 폼즈	
parodius	Q版沙罗曼蛇 	Parodius DA! 	파로디우스다! - 신화에서 웃음으로 	
pass	长舌超人	Pass	패스	
pbancho	番长大逆转方块 	Gyakuten!! Puzzle Bancho 	역전! 퍼즐대장 	
pbillrd	完美撞球	Perfect Billiard	퍼팩트 빌리어드	
penbros	企鹅兄弟 	Penguin Brothers 	펭귄 브러더스 	
pengo	企鹅推冰 	Pengo 	펭고 	
percuss	太空杀机	The Percussor	퍼커서	
perfrman	火蚁超人 	Performan 	퍼포맨 	
phoenix	火凤凰 	Phoenix 	피닉스 	
photof	赛马	Photo Finish	포토 피니시	
phozon	原子图形 	Phozon 	포존 	
pipibibs	皮皮与比比	Pipi & Bibis 	피피 & 비비스 	
pipibibsa	皮皮与比比 II  	Pipi & Bibis II	피피 & 비비스 II	
pirates	海盗 	Pirates	해적들	
pitfall2	玛雅历险记  	Pitfall  	핏폴  	
pitfall2a	玛雅历险记 II 	Pitfall II 	핏폴 II 	
pktgaldx	美女花式桌球 	Pocket Gal Deluxe 	포켓 걸 디럭스 	
pkunwar	企鹅大战 	Penguin-Kun Wars 	펭귄군 워즈 	
pleiads	火凤凰 2 	Pleiads 	플리어즈 	
plgirls	美女砖王	Play Girls	플레이 걸스	
plusalph	趣味战机	Plus Alpha	플러스 알파	
poitto	魔法宝瓶	Poitto!	포이또!	
pollux	雷霆旋风 	Pollux 	폴룩스 	
polluxa	雷霆旋风 II 	Pollux (set 2)	폴룩스 (세트 2)	
ponpoko	欢乐碰碰鸟	Ponpoko	너구리	
pooyan	猪仔射狼	Pooyan	뿌얀	
popbounc	跳跳球 	Pop 'n Bounce 	팝 앤 바운스	
popeye	大力水手 	Popeye 	뽀빠이 	
popflame	老鼠灭气球 	Pop Flamer 	팝 플레이머 	
porky	小猪历险	Porky	포키	
porter	海男 	Port Man 	포트맨 	
preisle2	原始岛 2	Prehistoric Isle 2	원시도 2 / 프리히스토릭 아일 2	
progress	大战车	Progress	프로그래스	
psurge	电路小精灵	Power Surge	파워 서지	
pturn	平行滑雪	Parallel Turn	패러럴 턴	
pulirula	普利路拉传说 	PuLiRuLa 	푸리룰라 	
punkshot	庞克篮球 (4 Players)	Punk Shot (4 Players)	펑크 샷 ( 4인용)	
punkshot2	庞克篮球 (2 Players)	Punk Shot (2 Players)	펑크 샷 ( 2인용)	
pururun	普路路魔咒	Pururun	푸루룬	
pushman	推石超人 	Pushman 	푸쉬맨 	
pushmana	推石超人 II  	Pushman (set 2)	푸쉬맨 (세트 2)	
puzznic	宝石仓库番 	Puzznic 	퍼즈닉 	
pyros	瓦德纳森林 	Pyros 	파이로스 	
pzlbowl	泡泡保龄球 	Puzzle De Bowling 	퍼즐로 볼링 	
pzlbreak	益智游戏	Puzzle Break	퍼즐 브레이크	
qbert	立体跳方块 	Q*bert 	큐*버트 	
qberta	立体跳方块 II	Q*bert (set 2)	큐*버트 ( 세트 2)	
qcrayon	问答 蜡笔小新 	Quiz Crayon Shinchan 	퀴즈 크레용 신쨩 	
quartet	星战四人组 	Quartet 	쿼텟 	
quester	打砖块卫星 	Quester 	퀘스터 	
rabiolep	兔战士 	Rabio Lepus 	라비오 리퍼스 
radrad	无敌风火轮	Radical Radial	래디칼 래디얼	
raflesia	银河系战机 	Rafflesia 	라플레시아 	
riot	雷轧斗	Riot	라이엇	
raiders5	大战略 5	Raiders5	레이더스5	
raiga	雷牙 	Raiga - Strato Fighter 	뇌아 	
raimais	光速飞跃车 	Raimais 	레이메이스 	
raphero	雷豹英雄	Rapid Hero	라피드 히어로	
redhawk	红鹰 	Red Hawk 	레드 호크 	
redrobin	红色知更鸟	Red Robin	레드 로빈	
repulse	凤凰之子 - 星际联邦	Repulse	리펄스	
retofinv	侵略者回归	Return of the Invaders	돌아온 인베이더	
rezon	雷杀之星	Rezon	레존	
vsgongf	战斗拳击	Gong Fight	링 파이터	
ringfgt	VS 战斗拳击 	Ring Fighter 	링 파이터 	
ringfgt2	VS 战斗拳击 II 	Ring Fighter (set 2)	링 파이터 (세트 2)	
riotcity	暴乱之城 	Riot City 	라이엇 시티 	
roadf	马路英雄 	Road Fighter 	로드 파이터 	
roadf2	马路英雄 II	Road Fighter (set 2)	로드 파이터 (세트 2)	
robocop	铁甲威龙 	Robocop 	로보캅 	
rockn	摇滚乐队 1 	Rock'n  1	로큰 1	
rockn4	摇滚乐队 4 	Rock'n 4 	로큰 4 	
rockrage	恋爱热摇滚 	Rock'n Rage 	사랑의 핫 락 	
rocktris	摇摆俄罗斯方块	Rock Tris	락 트리스	
rollerg	暴力溜冰 	Rollergames 	롤러게임스 	
rompers	吊带小子 	Rompers 	롬퍼즈 	
rshark	太空飞鲨	R-Shark	R-샤크	
rthunder	滚雷	Rolling Thunder	롤링 썬더	
rtype2	异形战机 II	R-Type II	R 타입 II	
rundeep	深水炸弹	Run Deep	런 딥	
rushatck	绿色兵团 	Rush'n Attack 	러쉬 앤 어택 	
rygar	阿尔卑斯古战士 	Rygar 	아르고스의 전사 / 라이거 	
ryukyu	琉球 	RyuKyu 	유구 	
s1945	彩京1945	Strikers 1945	스트라이커스 1945
s1945k	打击者 1945K 	Strikers 1945 K 	스트라이커즈 1945k 	
sabotenb	仙人掌兄弟 	Saboten Bombers 	선인장 봄버스 	
sabotenba	仙人掌兄弟 II 	Saboten Bombers (set 2)	선인장 봄버스 (세트 2)	
sadari	沙达利方块	Sadari	사다리	
sailormn	美少女战士 - 水手月亮 	Pretty Soldier Sailor Moon 	미소녀전사 세일러문 	
samuraia	战国世纪 	Samurai Aces	전국 에이스 / 사무라이 에이스 	
sandscrp	沙漠之蝎	Sand Scorpion	샌드 스콜피온	
savgbees	超浮游要塞 - 致命大黄蜂	Savage Bees	세비지 비즈	
sbbros	超级魔鬼气泡 	Super Buster Bros. 	슈퍼 버스터 브러더스 	
schmeisr	格斗机器人 	Schmeiser Robo 	슈마이저 로보 	
scobra	超级眼镜蛇	Super Cobra	슈퍼 코브라	
scotrsht	未来滑车大对决	Scooter Shooter	스쿠터 슈터	
scramblb	紧急起飞 混乱 	Scramble 	스크램블 	
sdfight	SD斗士 	SD Fighters 	SD 파이터즈 	
sdgndmps	机动战士SD高达 - 塞可沙拉曼达的威胁	SD Gundam Psycho Salamander no Kyoui	기동전사 SD 건담 사이코 사라만사의 위협	
searcharu	异型大作战 	SAR - Search And Rescue	SAR - 구조대 	
searchp2	超级找一找 - 搜寻之眼 Plus 	Search Eye Plus 	숨은그림찾기 Plus 	
sectionz	Z 地带 	Section Z 	섹션 Z 	
sectionza	Z 地带 II	Section Z (set 2)	섹션 Z (세트 2)	
semibase	棒球 (SemiCom Baseball) 	MuHanSeungBu (SemiCom Baseball) 	무한승부 - 전원국제리그전 	
shadoww	忍者龙剑传 	Shadow Warriors 	닌자용검전 / 쉐도우 워리어즈 	
shaolins	少林之道 	Shao-lin's Road 	샤오린의 길	
shinobi	超级忍 	Shinobi	 시노비 	
shocking	狼人王	Shocking	쇼킹	
shogwarr	幕府快打 	Shogun Warriors 	쇼군 워리어즈 	
sidepckt	瞄准腰袋 	Side Pocket 	사이드 포켓 	
sonson	西游记	Son Son	손 손	
chinagat	西游降魔录 - 流棒妖技之章 	China Gate 	서유항마록	
simpsons	辛普森家庭 (4 Players )	The Simpsons (4 Players )	심슨 가족 (4인용 )	
simpsons2p	辛普森家庭 (2 Players )	The Simpsons (2 Players )	심슨 가족 (2인용 )	
skyadvntu	天空大冒险 	Sky Adventure 	스카이 어드벤처 	
skyalert	天空防卫队	Sky Alert	스카이 얼럿	
skyarmy	天空军队	Sky Army	스카이 아미	
skybase	天空基地	Sky Base	스카이 베이스	
skykid	天堂鸟 	Sky Kid 	스카이 키드 	
skylancr	天空雷射枪	Sky Lancer	스카이 랜서	
skyskipr	天空船长	Sky Skipper	스카이 스키퍼	
skysmash	空中打击	Sky Smasher	스카이 스매셔	
skywolf2	天狼 II	Sky Wolf (set 2)	스카이 울프 (세트 2)	
skywolf3	天狼 III	Sky Wolf (set 3)	스카이 울프 (세트 3)	
snapjack	外星小精灵	Snap Jack	스냅 잭	
snapper	贪食蛇 - 鳄龟 	Snapper 	스내퍼 	
sngkace	战国世纪 	Sengoku Ace 	전국 에이스	
snowbros	雪人兄弟 - 尼克和汤姆 	Snow Bros. - Nick & Tom 	스노우 브러더스 - 닉 & 톰 	
snowbro2	雪人兄弟 2 	Snow Bros. 2 	스노우 브러더스 2 	
sokonuke	心愿猫咪对战游戏 	Sokonuke Taisen Game 	소코누케 대전 게임 	
soldam	苏登益智方块	Soldam	솔담	
solomon	所罗门之钥 	Solomon's Key 	솔로몬의 열쇠 	
sonicwi	音速之翼 	Sonic Wings 	소닉 윙즈 	
sonicwi2	音速之翼 2	Sonic Wings 2 	소닉 윙즈 2	
sonicwi3	音速之翼 3	 Sonic Wings 3	소닉 윙스 3	
sonofphx	凤凰之子	Son of Phoenix	피닉스의 아들	
sotsugyo	卒业证书	Sotsugyo Shousho	졸업증서	
spang	超级魔鬼气泡 	Super Pang 	슈퍼 팡 	
speedspn	真实乒乓球	Speed Spin	스피드 스핀	
spelunk2	洞穴探险 II	Spelunker II	스페랑카 II	
spelunkr	洞穴探险	Spelunker	스페랑카	
spinlbrk	时空英雄 	Spinal Breakers 	스파이널 브레이커즈 	
springer	跳跃者	Springer	스프링거	
spy	S.P.Y. - 特别计划 Y 	S.P.Y. - Special Project Y 	S.P.Y. - 스페셜 프로젝트 Y 	
sraider	太空雷达	Space Raider	스페이스 레이더	
srdmissn	S.R.D. 任务	S.R.D. Mission	S.R.D. 미션	
srumbler	高速追击令 	The Speed Rumbler 	스피드 럼블러	
ssmissin	SS 任务 - 特命编	S.S. Mission	S.S. 미션	
ssriders	落日骑士 (4 Players )	Sunset Riders (4 Players ) 	선셋 라이더스 ( 4인용 버전 )	
ssridersubc	落日骑士 (2 Players )	Sunset Riders (2 Players ) 	선셋 라이더스 ( 2인용 버전 )	
ssridersuda	落日骑士II (4 Players )	Sunset RidersII (4 Players ) 	선셋 라이더스 II( 4인용 버전 )	
stagger1	红鹰 	Stagger I 	스테거 I 	
starfght	小蜜蜂	Star Fighter	스타 파이터	
starjack	星际母舰 	Star Jacker 	스타 재커 	
stg	重装战机 S.T.G	Strike Gunner S.T.G	스트라이크 거너 S.T.G	
stinger	赤猬战机	Stinger	스팅거	
stlforce	钢铁力量	Steel Force	스틸 포스	
stratof	雷牙 	Raiga - Strato Fighter 	뇌아	
strider	出击飞龙 	Strider 	스트라이더 비룡	
sub	潜艇	Submarine	서브마린	
supbtime	超级汉堡时代 	Super Burger Time 	슈퍼 버거 타임	
supbtimea	超级汉堡时代 II	Super Burger Time (set 2)	슈퍼 버거 타임 (세트 2)	
superman	超人	Superman	슈퍼맨	
superx	超级战机 (NTC)	Super-X (NTC)	슈퍼 X (NTC 판)	
suprridr	超级车手	Super Rider	슈퍼 라이더	
suprtrio	超级三重奏	Super Trio	슈퍼 트리오	
suratk	奇袭 - 星战大怒吼 	Surprise Attack 	서프라이즈 어택 	
survarts	死亡艺术 	Survival Arts 	서바이벌 아츠 	
svf	超级对战足球	Super Visual Football: European Sega Cup	슈퍼 비주얼 풋볼: 유럽 세가컵	
swat	超能战警 	SWAT 	스왓 	
sws	超级世界棒球 	Super World Stadium 	슈퍼 월드 스타디움 	
sws93	超级世界棒球 '93 	Super World Stadium '93 	슈퍼 월드 스타디움 '93 	
tangtang	堂堂 	Tang Tang 	탕 탕 	
tankfrce	坦克部队 (2 Player)	Tank Force ( 2 Player)	탱크 포스 ( 2인용)	
taotaido	苏婆诃格斗 - 太鸥体道	Tao Taido 	타오 체도 	
tetrisp2	俄罗斯方块 Plus 2 	Tetris Plus 2 	테트리스 Plus 2 	
thedeep	水雷艇 	The Deep 	딥 	
pwrinst2j	豪血寺一族 2 	Gouketsuji Ichizoku 2 	호혈사일족 2 	
theend	射蜘蛛	The End	디 엔드	
thehustl	撞球高手 - 骗子	The Hustler 	허슬러 	
thndrx2	雷霆战机 2 	Thunder Cross 2	썬더 크로스 2 	
thndrx2a	雷霆战机 2a 	Thunder Cross 2a 	썬더 크로스 2a 	
thoop	闪电投篮	Thunder Hoop 	썬더 후프 	
thunderl	雷与电砖块物语	Thunder & Lightning	썬더 & 라이트닝	
thunderx	雷霆战机  	Thunder Cross  	썬더 크로스 	
thunderxa	雷霆战机 II	Thunder Cross II	썬더 크로스 II	
thunderxb	雷霆战机 III	Thunder Cross III	썬더 크로스 III	
thundfox	雷狐行动 	Thunder Fox 	썬더 폭스 	
tigerh	老虎直升机 	Tiger Heli 	타이거 헬리 	
timelimt	刻不容缓	Time Limit	타임 리미트	
timeplt	时空大战	Time Pilot	타임 파일럿	
tmnt	忍者神龟 (4 Players)	Teenage Mutant Ninja Turtles (4 Players)	닌자거북이 (4인용)	
tmnt2	忍者神龟 2 (4 Players )	Teenage Mutant Ninja Turtles (4 Players)	닌자거북이 - 시간 속의 거북이 (4인용)	
tmht22pe	忍者神龟 2 (2 Players)	Teenage Mutant Hero Turtles (2 Players)	닌자거북이 - 시간 속의 거북이 (2인용)	
tndrcade	特殊部队	Thundercade	특수부대 U.A.G. 	
toki	人猿泰山	Toki	타잔	
tokisens	时间战士	Toki no Senshi - Chrono Soldier	시간의 전사 - 크로노 솔져	
toppyrap	兔与龟	Toppy & Rappy	토피 & 래피	
toride2g	牌砦 II - 仇讨外传	Toride II Adauchi Gaiden	패채 2 - 구토외전	
toryumon	登龙门	Toryumon	등용문 (登龍門)	
transfrm	变形金刚 	Transformer	트랜스포머	
travrusa	横越美国	Traverse USA	트래버스 USA	
triothep	艳拳三强男 - 胜负拳 	Trio The Punch - Never Forget Me... 	트리오 더 펀치 - 나를 잊지 마세요... 	
triothepj	艳拳三强男 - 胜负拳 II	Trio The Punch - Never Forget Me... II	트리오 더 펀치 - 나를 잊지 마세요... II	
triplfun	三倍乐趣	Triple Fun	트리플 펀	
trojan	斗者挽歌 - 特洛伊 	Trojan 	트로젠	
turtship	海底大冒险 	Turtle Ship 	거북선 	
tutankhm	图坦卡门	Tutankham	투탕카멘	
twinactn	孪生劫	Twin Action	트윈 액션	
twinadv	哥俩好大冒险 	Twin Adventure 	트윈 어드벤쳐 	
twinbrat	捣蛋兄弟 	Twin Brats 	트윈 브래츠 	
twinbrata	捣蛋兄弟 II	Twin Brats II	트윈 브래츠 II	
twineag2	双鹰 II	Twin Eagle II - The Rescue Mission	트윈 이글 II - 구출임무	
twineagl	双鹰	Twin Eagle - Revenge Joe's Brother	트윈 이글 - 조 형제의 복수	
twinfalc	双隼	Twin Falcons	트윈 팰콘스	
twinkle	闪亮小精灵	Twinkle	트윙클	
ringfgt2	VS 战斗拳击 II 	Ring Fighter (set 2)	링 파이터 (세트 2)
uballoon	终极气球	Ultra Balloon	울트라 벌룬	
ufosensi	幽浮战士	Ufo Senshi Yohko Chan	UFO 전사 요코짱	
ultrax	 科幻特效游戏	Ultra X Weapons 	울트라 경비대 - 공상특촬게임	
umanclub	战斗! 奥特曼兄弟	Tatakae! Ultraman Kyoudai	울트라맨 클럽 - 싸워라! 울트라맨 형제!!	
unclepoo	Poo 叔叔	Uncle Poo	푸 삼촌	
unsquad	战区 88 	U.N. Squadron 	에어리어 88	
uopoko	小猫钓鱼 	Puzzle Uo Poko 	퍼즐 물고기 포코 	
utoukond	奥特曼斗魂传说 	Ultra Toukon Densetsu 	울트라 투혼전설 	
vangrd2	先锋号 II	Vanguard II	뱅가드 II	
vanvan	冲冲车	Van-Van Car	방방 카	
vanvank	冲冲车 I	Van-Van Car I	방방 카 I	
vanvanb	冲冲车 II	Van-Van Car II	방방 카 II	
varth	雷暴行动 	Operation Thunderstorm 	오퍼레이션 썬더스톰 	
vasara	婆裟罗	Vasara	바사라 (婆裟羅)	
vasara2	婆裟罗  I	Vasara 2 (set 1)	바사라 2 (婆裟羅 2) (세트 1)	
vasara2a	婆裟罗  II 	Vasara 2 (set 2)	바사라 2 (婆裟羅 2) (세트 2)	
viofight	暴力格斗 	Violence Fight 	바이얼런스 파이트 	
vmetal	钢铁任务	Varia Metal	바리아 메탈	
wanted	勇闯印第安	Wanted	원티드	
wardner	瓦德纳森林	Wardner 	와드너 	
watrball	水球	Water Balls	워터 볼	
wboy	神奇男孩	Wonder Boy 	원더보이 	
wb3	神奇男孩 III - 在魔界 	Wonder Boy III - Monster Lair 	원더보이 III - 몬스터 레어	
wbdeluxe	神奇男孩 豪华版	Wonder Boy Deluxe	원더보이 디럭스	
wc90b1	欧洲联盟 	Euro League 	유로리그 	
wc90b2	世界杯足球 '90	Worldcup '90	월드컵  '90	
welltris	立体空间俄罗斯 	Welltris 	웰트리스 	
wheelrun	狂奔之轮	Wheels Runner	휠즈 러너	
whizz	双隼 Whizz	Whizz	휘즈	
wildfang	邪城风云	Wild Fang	와일드 팽	
wintbob	雪人兄弟 - 尼克和汤姆 	The Winter Bobble 	윈터 보블 	
wits	维兹超人 	Wit's 	윗츠 	
wiz	巫师	Wiz	위즈	
wndrmomo	神奇女孩	Wonder Momo	원더 모모	
worldwar	世界大战 	World Wars 	세계대전 	
wrally	世界拉力赛车 	World Rally 	월드 랠리 	
wrallya	世界拉力赛车 II  	World Rally II	월드 랠리 II	
wrestwar	摔跤大战	Wrestle War	레슬 워 	
wrestwar1	摔跤大战 II	Wrestle War II	레슬 워 II	
wrofaero	空战 	War of Aero 	워 오브 에어로	
wwjgtin	趣味赛马	Wai Wai Jockey Gate-In 	와이와이 조키 게이트인	
xexex	新锐惑星 	Xexex  	젝세스 	
xexexj	新锐惑星 II	Xexex II	젝세스 II	
xmultipl	X 再生战机 	X Multiply 	X 멀티플라이	
xorworld	XOR 世界 	Xor World 	Xor 월드 	
xxmissio	XX 任务	XX Mission	XX 미션	
yamagchi	山口君大冒险	Yuke Yuke Yamaguchi-kun	결사의 탐험 서바이벌 가자 가자!	
yiear	功夫小子 	Yie Ar Kung-Fu 	이 얼 쿵후	
youjyudn	妖兽传 	Youjyuden 	요수전 	
zingzip	真真急炮	Zing Zing Zip	징 징 집	
zoar	隐形战机 Zoar	Zoar	조어	
zodiack	太空飞艇	Zodiack	조디악	
bigtwin	大蛮生	Big Twin	빅 트윈	
birdtry	博蒂物语 	Birdie Try 	버디 트라이 	
blkdrgon	暗黑之龙	Black Dragon 	블랙 드래곤 	
changes	毛毛虫 - 变幻	Changes	체인지	
ctribe	流氓大混战 	The Combatribes 	컴뱃라이브스 	
cworld2j	问答 卡普空世界 2 	Adventure Quiz Capcom World 2 	어드벤쳐 퀴즈 캡콤 월드 2 	
dacholer	鸵鸟	Dacholer	다촐러	
desertbr	沙漠王 	Desert Breaker 	데저트 브레이커 	
dinorex	恐龙传说 	Dino Rex 	디노 렉스 	
djboy	DJ 男孩 	DJ Boy 	DJ 보이 	
dorodon	迷宫精灵 	Dorodon 	도로돈 	
dorodon2	迷宫精灵 II	Dorodon (set 2)	도로돈 (세트 2)	
dorunrun	小丑贝洛 	Do! Run Run	도! 런 런 	
f1gp	一级方程式 GP 大赛	F-1 Grand Prix	F-1 그랑프리	
galaxian	小蜜蜂 	Galaxian 	갤럭시안 	
zerotime	小蜜蜂 - 难度加强版	Zero Time	제로 타임	
genpeitd	源平讨魔传	Genpei ToumaDen	원평토마전	
invaders	宇宙侵略者 M	Space Invaders M	스페이스 인베이더 M	
jailbrek	越狱 - 曼哈顿 24 分署	Jail Break	맨하탄 24분서 / 제일 브레이크	
loht	汤玛魔界历险	Legend of Hero Tonma	영웅 톤마의 전설	
mainevt	拳击擂台	The Main Event 	링의 왕자 	
megadon	马嘉登火箭	Megadon	메가돈	
ninjemak	妖魔忍法帖 	Ninja Emaki 	요마인법첩 	
ozmawars	奥兹玛战争 	Ozma Wars 	오즈마 워즈 	
redufo	红飞碟	Red UFO	붉은 UFO		
speakres	太空防卫 - Speak & Rescue	Speak & Rescue	스피크 & 레스큐	
tazmania	疯狂塔斯 	Tazz-Mania 	태즈매니아 	
toypop	童话世界	Toypop	토이팝	
tsamurai	侍日本一 	Samurai Nihon-ichi 	사무라이 일본 제일	
warpwarp	娃娃兵	Warp & Warp	워프 & 워프	
wiping	吸尘器	Wiping	와이핑	
yamato	大和号 	Yamato 	야마토	
eagle	月冠登陆艇 	Eagle  	이글	
eagle2	月冠登陆艇 II	Eagle II	이글 II	
eagle3	月冠登陆艇 III	Eagle III	이글 III	
mooncrst	月冠登陆艇 - 三台合体  	Moon Cresta 	문 크레스타	
uniwars	银河帝国的反击	UniWar S	유니워 S	
devilfsh	魔神鱼类	Devil Fish	데빌 피쉬	
mshuttle	登月火箭	Moon Shuttle	문 셔틀	
nemesis	宇宙巡航舰	Nemesis	그라디우스	
nprinces	忍者公主	Ninja Princess	닌자 공주	
pisces	双鱼座	Pisces	피시즈	
pootan	猪仔射狼	Pootan	뿌탄	
anteater	食蚁兽	Anteater	앤트이터	
drakton	迷宫飞机 	Drakton 	드랙톤 	
fightrol	滚轴王牌	Fighting Roller	파이팅 롤러	
horekid	太空宝宝大作战	Kid no Hore Hore Daisakusen	키드의 호레호레 대작전	
kittenk	猫咪仓库番	Kitten Kaboodle	키튼 커부들	
mmonkey	恶搞猴王	Minky Monkey	밍키 몽키	
mplanets	疯狂星球	Mad Planets	매드 플래닛스	
mustache	胡须男孩	Mustache Boy	마스타슈 소년	
paddlema	球拍也疯狂	Paddle Mania	패들매니아	
pairlove	爱的纸牌对对碰	Pairs Love	페어즈 러브	
hustler	电视撞球	Video Hustler	비디오 허슬러	
timescan	时空弹珠台 	Time Scanner 	타임 스캐너 	
trckydoc	机智博士 	Tricky Doc 	트릭키 덕 	
wilytowr	威利电厂	Wily Tower	와일리 타워	
puzlclub	解谜俱乐部 	Puzzle Club 	퍼즐 클럽 	
qcrayon2	蜡笔小新	Crayon Shinchan Orato Asobo	크레용 신쨩 나랑 놀자	
sgladiat	神鬼战士 1984	Gladiator 1984	글라디에이터 1984	
shtrider	射击机车手	Shot Rider	샷 라이더	
tshingen	武田信玄 	Shingen Samurai-Fighter 	신겐 사무라이 파이터 	
tshingena	武田信玄 II	Takeda Shingen II	다케다 신겐 II	
wjammers	超级飞碟球	Windjammers	윈드잼머스	
bwingso	B-计划 II 	B-Wings II	B-윙즈 II 	
cawing	雌虎战机 	Carrier Air Wing 	캐리어 에어윙 	
cawingu	雌虎战机 II	Carrier Air Wing II	캐리어 에어윙 II	
dambustr	皇家空军中队 - 丹巴斯特 	Dambusters 	댐버스터즈 	
forgottn	失落的世界 	Forgotten Worlds 	포가튼 월드 (세계판)	
kicker	踢球者	Kicker	소림사로 가는길 / 키커	
kungfut	功夫大君	Kung-Fu Taikun	쿵후대군	
lkage	影子传说	The Legend of Kage	카게의 전설	
mimonkey	世纪猴王	Mighty Monkey	마이티 몽키	
mrjong	麻将先生 	Mr. Jong 	미스터 종 	
pistoldm	手枪大名冒险 	Pistol Daimyo no Bouken 	피스톨 대명의 모험  	
rocnrope	凤凰猎人	Roc'n Rope	락 앤 로프	
gdfs	机动战士高达 - 最后射击	Mobil Suit Gundam Final Shooting	기동전사 건담 파이널 슈팅	
altbeast2	兽王记 (第2套)	Altered Beast (set 2)	얼터드 비스트 (세트 2)	
altbeast4	兽王记 (第4套)	Altered Beast (set 4)	얼터드 비스트 (세트 4)	
armorcar	装甲车 (第1套)	Armored Car (set 1)	아머드 카 (세트 1)	
buzzard	猎鹰直升机	Buzzard	버자드	
ckongg	大金刚	Crazy Kong	크레이지 콩	
crazycop	疯狂警察	Crazy Cop 	크레이지 캅 	
downtown	城市快打 - 目击	DownTown	목격자	
edfu	E.D.F. - 地球防卫军	E.D.F. : Earth Defense Force	E.D.F. : 지구방위군	
koshien	呜呼荣光甲子园 	Ah Eikou no Koshien 	오호 영광의 갑자원	
lgtnfght	火龙 	Lightning Fighters 	라이트닝 파이터즈 	
logicpro	逻辑 PRO	Logic Pro 	로직 프로 	
mrtnt	炸药先生	Mr. TNT	미스터 TNT	
quartet2	星战四人组 2 	Quartet 2 	쿼텟 2 	
trigon	火龙-激光战机 	Trigon 	트라이곤 	
airwolf	飞狼	Airwolf	에어울프	
hippodrm	竞技场 	Hippodrome 	히포드롬 	
ladykill	美女杀手	Lady Killer	레이디 킬러	
quizo	问答奥林匹克 	Quiz Olympic 	퀴즈 올림픽 	
qzquest	问答搜查 - 英雄美女物语 	Quiz Quest - Hime to Yuusha no Monogatari 	퀴즈 퀘스트 - 공주와 용자의 이야기 	
yesnoj	心电图	Yes/No Sinri Tokimeki Chart	예스.노 심리 두근두근 차트	
garuka	饿流祸 II	Garuka II	약탈자 II		
dinou	恐龙新世纪	Cadillacs and Dinosaurs 	캐딜락 & 다이노소어 	
gaia	征战者	Gaia Crusaders	가이아 크루세이더	
mia2	绿色军团2	Missing In Action II	Missing In Action II	
eswatbl	霹雳双警	E-Swat Cyber Police	E-Swat Cyber Police	
astorm	异形风暴	Alien Storm	Alien Storm	
altbeast	兽王记	Altered Beast	Altered Beast	
swatpolc	超级特警	Swat Police	Swat Police	
batsuguna	疯狂枪支	Batsugun	Batsugun	
batsugunsp	疯狂枪支特别版	Batsugun-Special	Batsugun-Special	
pacman	吃豆精灵1	Pac-Man	Pac-Man	
gradius2	宇宙巡航舰2	Vulcan Venture2	Vulcan Venture2	
dremshpr	购物梦语	Dream Shopper	드림쇼퍼 	
drtomy	汤米医生	Dr.Tomy	닥터토미	
eggor	射蛋	Eggor	에거 	
fantzone	神奇地带	Fantasy Zone	판타존 	
fghtbskt	战斗篮球	Fighting Basketball	파이팅바스켓볼	
finalb	最终打击	Final Blow	파이널 블로	
forgottnu	失落的世界	Forgotten Worlds	잊혀진세계	
fpoint	世嘉俄罗斯方块解谜	Flash Point	플래시포인트		
guwange	狱门山物语	Guwange	 구완지	
guzzler	水精灵	Guzzler	 거즐러	
gwarrior	银河战士	Galactic Warriors	 갈락틱워리어	
gyruss	太空射击战	Gyruss	 쥐러스		
hedpanic	头槌小子	Head Panic	 헤드패닉 	
hitice	暴力冰上曲棍球	Hit the Ice	 바이런스온더아이스하키 	
hookj	铁钩船长	Hook	 미털비크캡틴	
hotshock	惊悚狂热	Hot Shocker	 핫쇼커 	
hunchbkg	驼背骑士 (小蜜蜂 硬件)	Hunchback	 헌치백 	
hunchbks	驼背骑士	Hunchback	 헌츠백	
imsorry	课长捡砖块	I'm Sorry	 아임쏘리 	
1943kai	1943加强版	1943 Kai : Midway Kaisen	 1943카이	
agressb	阿古雷司-导弹大战略	Agress	 어그레스 	
aligatorun	鳄鱼猎手	Alligator Hunt	 엘리게이터 헌터 	
armwrest	超越巅峰	Arm Wrestling	 비얀드더타프 	
asterix	美丽新世界	Asterix	 아스테릭스 	